9
11
#####W#####
####WMW####
###W F W###
##WWBTBWW##
#WBWB  W W#
WB  BBB  KW
W BBB  BB W
#WP B  B W#
##WWWWWWW##