8
9
#####WW##
##WWW PW#
#W  D  W#
#W D DW##
W  WWWW##
W B  B W#
W B B FMW
WWWWWWWW#