8
9
##WWWW###
#W    WW#
#WDWtt  W
W tWWBBBW
W  WW t W
WP WWFD W
#WW#WMFDW
#####WWW#