9
10
######WW##
#####WMFW#
###WWWWTW#
##W tt FPW
##WtWtW  W
#WW  DttWW
WKWtWtW W#
W     D W#
#WWWWWWW##