7
10
#W#WWW####
WPWK BWW##
W BtB T WW
WB B BBFMW
W B B BBFW
#W B B WW#
##WWWWW###