9
8
####WW##
###WFMW#
#WW TB W
WPWt B W
W W t tW
WDWBBBBW
Wt t  tW
#WWWWWKW
######W#