10
9
##WWW####
#W P W###
#WBBBW###
W    W###
#WtB  WW#
#WDWBB  W
#W  B KW#
##WWWTB W
####WFMW#
#####WW##