9
8
####WW##
###WMFW#
#WWW T W
W KWBBBW
WDB DB W
W WD  PW
WtWWtWW#
WttttW##
#WWWW###