14
11
#WWWWWWWWW#
W   FMF   W
W  W D W  W
W    D    W
W  W D W  W
W    D    W
W  W D W  W
W    D    W
#W W D W W#
#W   D   W#
#W W   W W#
#W   P   W#
##WW   WW##
####WWW####